30
30
PPPPPPPPPPPPPPPPPPPPPPPPPPPPPP
PPPPPPPPPPPPPPPPPPPPPPPPPPPPPP
PPPPPPPPPPPPPPPPPPPPPPPPPPPPPP
PPPGTSSSSSSSSSSSSSSBSBBBBSSPPP
PPPTTSMMMMMMMMMSSSBSSBBBSSBPPP
PPPTSSMSSSSSSSMSSBBSBBBSSBBPPP
PPPSKSMSSSSSSSMSBBBSSBSSBBBPPP
PPPSSTMSSMMMSSMSBBSSBBSSBBBPPP
PPPSSTMSSMMMSSMSBBBSSBSSBBKPPP
PPPTSTMSSSSSSSMBBBSSSSSSBBBPPP
PPPTTTMSSSSSSSMBBBDSSSSBBBBPPP
PPPSSSMMMSSSMMMSBBBSSBSSBBBPPP
PPPSSSSSSSSSSSSSSSBSSBSSBBBPPP
PPPSSSSSSSSSSSSSSSSSSSSBBBSPPP
PPPSSSSSSSSTTAABBBBSSSBBBSGPPP
PPPSSSSSSSTTTTATTBASSBSBSSBPPP
PPPSSSSSTTTTTTAAAAABSSSSSBBPPP
PPPTTTTTTTTTTTTAAABSSSSSBBBPPP
PPPTTTTTTSSSTKTAABSSBBBBBBBPPP
PPPSSSTTTSTTTTTAASSSSBBBBBBPPP
PPPSGSSTTSTTTTAABSSSSSBBBBBPPP
PPPTSSTSTSSSDTAABBSSBSSBBBBPPP
PPPTTSTSSTTTTTAABSSBBSSBBBBPPP
PPPTSTTSSTTTTAAABBSSBBSSBBBPPP
PPPTSSTSTTTTAAABBBBSSBBSXBBPPP
PPPSBBBBBAAAAABSSSBBSSBSSBSPPP
PPPBBBBBAAAAABSSBBBBBBSSSSSPPP
PPPPPPPPPPPPPPPPPPPPPPPPPPPPPP
PPPPPPPPPPPPPPPPPPPPPPPPPPPPPP
PPPPPPPPPPPPPPPPPPPPPPPPPPPPPP
