100
100
PPPPPPPPPPPPPPPPPPPPPPPPPPPPPPPPPPPPPPPPPPPPPPPPPPPPPPPPPPPPPPPPPPPPPPPPPPPPPPPPPPPPPPPPPPPPPPPPPPPP
PPPPPPPPPPPPPPPPPPPPPPPPPPPPPPPPPPPPPPPPPPPPPPPPPPPPPPPPPPPPPPPPPPPPPPPPPPPPPPPPPPPPPPPPPPPPPPPPPPPP
PPPPPPPPPPPPPPPPPPPPPPPPPPPPPPPPPPPPPPPPPPPPPPPPPPPPPPPPPPPPPPPPPPPPPPPPPPPPPPPPPPPPPPPPPPPPPPPPPPPP
PPPSSSSSSSMMMSSSMMMSSSMMMSSSMMMSSSMMMSSSMMMSSSMMMSMMMSSSMMMSSSMMMSSSMMMSSSMMMSSSMMMSSSMMMSSSMMMSSPPP
PPPSSSMMMSSSMMMSSSMMMSSSMMMSSSMMMSSSMMMSSSMMMSMMMSSSMMMSSSMMMSSSMMMSSSMMMSSSMMMSSSMMMSSSMMMSSSMSSPPP
PPPSSSSMMMSSSMMMSSSMMMSSSMMMSSSMMMSSSMMMSSSMMMSMMMSSSMMMSSSMMMSSSMMMSSSMMMSSSMMMSSSMMMSSSMMMSSSMSPPP
PPPSSSSMMMSSSMMMSSSMMMSSSMMMSSSMMMSSSMMMSSSMMMSMMMSSSMMMSSSMMMSSSMMMSSSMMMSSSMMMSSSMMMSSSMMMSSSMSPPP
PPPSSSMMMSSSMMMSSSMMMSSSMMMSSSMMMSSSMMMSSSMMMSMMMSSSMMMSSSMMMSSSMMMSSSMMMSSSMMMSSSMMMSSSMMMSSSMSSPPP
PPPSSSSSSSMMMSSSMMMSSSMMMSSSMMMSSSMMMSSSMMMSSSMMMSMMMSSSMMMSSSMMMSSSMMMSSSMMMSSSMMMSSSMMMSSSMMMSSPPP
PPPSSSSSSSSSSSSSSSSSSSSSSSSSSSSSSSSSSSSSSSSSGSSSSSSSSSSSSSSSSSSSSSSSSSSSSSSSSSSSSSSSSSSSSSSSSSSSSPPP
PPPSSSSSSSSSSSSSSSSSSSSSSSSSSSSSSSSSSSSSSSSSSSSSSSSSSSSSSSSSSSSSSSSSSSSSSSSSSSSSSSSSSSSSSSSSSSSSSPPP
PPPSSSSSSSSSSSMMMSSSMMMSSSMMMSSSMMMSSSMMMSSSMMMSSSMMMSMMMSSSMMMSSSMMMSSSMMMSSSMMMSSSMMMSSSMMMSSSSPPP
PPPSSSMMMSSSMMMSSSMMMSSSMMMSSSMMMSSSMMMSSSMMMSMMMSSSMMMSSSMMMSSSMMMSSSMMMSSSMMMSSSMMMSSSMMMSSSMSSPPP
PPPSSSSMMMSSSMMMSSSMMMSSSMMMSSSMMMSSSMMMSSSMMMSMMMSSSMMMSSSMMMSSSMMMSSSMMMSSSMMMSSSMMMSSSMMMSSSMSPPP
PPPSSSSSSSSSSSSSSSSSSSSSSSSSSSSSSSSSSSSSSSSGSSSSSSSSSSSSSSSSSSSSSSSSSSSSSSSSSSSSSSSSSSSSSSSSSSSSSPPP
PPPSSSSSSSSSSSSSSSSSSSSSSSSSSSSSSSSSSSSSSSSSSSSSSSSSSSSSSSSSSSSSSSSSSSSSSSSSSSSSSSSSSSSSSSSSSSSSSPPP
PPPSSSSSSSMMMSSSMMMSSSMMMSSSMMMSSSMMMSSSMMMSSSMMMSMMMSSSMMMSSSMMMSSSMMMSSSMMMSSSMMMSSSMMMSSSMMMSSPPP
PPPSSSSSSSSMMMSSSMMMSSSMMMSSSMMMSSSMMMSSSMMMSSSMMMSMMMSSSMMMSSSMMMSSSMMMSSSMMMSSSMMMSSSMMMSSSMMMSPPP
PPPSSSSSSSSSMMMSSSMMMSSSMMMSSSMMMSSSMMMSSSMMMSSSMMMSMMMSSSMMMSSSMMMSSSMMMSSSMMMSSSMMMSSSMMMSSSMSSPPP
PPPSSSSSSSSSSMMMSSSMMMSSSMMMSSSMMMSSSMMMSSSMMMSSSMMMSMMMSSSMMMSSSMMMSSSMMMSSSMMMSSSMMMSSSMMMSSSMSPPP
PPPSSSSSSSSSSSMMMSSSMMMSSSMMMSSSMMMSSSMMMSSSMMMSSSMMMSMMMSSSMMMSSSMMMSSSMMMSSSMMMSSSMMMSSSMMMSSSSPPP
PPPSSSMMMSSSMMMSSSMMMSSSMMMSSSMMMSSSMMMSSSMMMSMMMSSSMMMSSSMMMSSSMMMSSSMMMSSSMMMSSSMMMSSSMMMSSSMSSPPP
PPPSSSSSSSSSMMMSSSMMMSSSMMMSSSMMMSSSMMMSSSMMMSSSMMMSMMMSSSMMMSSSMMMSSSMMMSSSMMMSSSMMMSSSMMMSSSMSSPPP
PPPSSSSSSSSMMMSSSMMMSSSMMMSSSMMMSSSMMMSSSMMMSSSMMMSMMMSSSMMMSSSMMMSSSMMMSSSMMMSSSMMMSSSMMMSSSMMMSPPP
PPPSSSSSSSMMMSSSMMMSSSMMMSSSMMMSSSMMMSSSMMMSSSMMMSMMMSSSMMMSSSMMMSSSMMMSSSMMMSSSMMMSSSMMMSSSMMMSSPPP
PPPSSSSSSSSSSSSSSSSSSSSSSSSSSSSSSSSSSSSSSSSSSSSSSSSSSSSSSSSSSSSSSSSSSSSSSSSSSSSSSSSSSSSSSSSSSSSSSPPP
PPPSSSSSSSSSSSSSSSSSSSSSSSSSSSSSSSSSSSSSSSSGSSSSSSSSSSSSSSSSSSSSSSSSSSSSSSSSSSSSSSSSSSSSSSSSSSSSSPPP
PPPSSSSSSSSSSMMMSSSMMMSSSMMMSSSMMMSSSMMMSSSMMMSSSMMMSMMMSSSMMMSSSMMMSSSMMMSSSMMMSSSMMMSSSMMMSSSMSPPP
PPPSSSSSSSSSSSMMMSSSMMMSSSMMMSSSMMMSSSMMMSSSMMMSSSMMMSMMMSSSMMMSSSMMMSSSMMMSSSMMMSSSMMMSSSMMMSSSSPPP
PPPSSSMMMSSSMMMSSSMMMSSSMMMSSSMMMSSSMMMSSSMMMSMMMSSSMMMSSSMMMSSSMMMSSSMMMSSSMMMSSSMMMSSSMMMSSSMSSPPP
PPPSSSSSSSSSMMMSSSMMMSSSMMMSSSMMMSSSMMMSSSMMMSSSMMMSMMMSSSMMMSSSMMMSSSMMMSSSMMMSSSMMMSSSMMMSSSMSSPPP
PPPSSSSSSSSMMMSSSMMMSSSMMMSSSMMMSSSMMMSSSMMMSSSMMMSMMMSSSMMMSSSMMMSSSMMMSSSMMMSSSMMMSSSMMMSSSMMMSPPP
PPPSSSSSSSMMMSSSMMMSSSMMMSSSMMMSSSMMMSSSMMMSSSMMMSMMMSSSMMMSSSMMMSSSMMMSSSMMMSSSMMMSSSMMMSSSMMMSSPPP
PPPSSSSSSMMMSSSMMMSSSMMMSSSMMMSSSMMMSSSMMMSSSMMMSMMMSSSMMMSSSMMMSSSMMMSSSMMMSSSMMMSSSMMMSSSMMMSSSPPP
PPPSSSSSSSSSSSSSSSSSSSSSSSSSSSSSSSSSSSSSSSSGSSSSSSSSSSSSSSSSSSSSSSSSSSSSSSSSSSSSSSSSSSSSSSSSSSSSSPPP
PPPSSSSSSSSSSSSSSSSSSSSSSSSSSSSSSSSSSSSSSSSSSSSSSSSSSSSSSSSSSSSSSSSSSSSSSSSSSSSSSSSSSSSSSSSSSSSSSPPP
PPPSSSSSSSSSMMMSSSMMMSSSMMMSSSMMMSSSMMMSSSMMMSSSMMMSMMMSSSMMMSSSMMMSSSMMMSSSMMMSSSMMMSSSMMMSSSMSSPPP
PPPSSSSSSSSSSMMMSSSMMMSSSMMMSSSMMMSSSMMMSSSMMMSSSMMMSMMMSSSMMMSSSMMMSSSMMMSSSMMMSSSMMMSSSMMMSSSMSPPP
PPPSSSSSSSSSSSMMMSSSMMMSSSMMMSSSMMMSSSMMMSSSMMMSSSMMMSMMMSSSMMMSSSMMMSSSMMMSSSMMMSSSMMMSSSMMMSSSSPPP
PPPSSSMMMSSSMMMSSSMMMSSSMMMSSSMMMSSSMMMSSSMMMSMMMSSSMMMSSSMMMSSSMMMSSSMMMSSSMMMSSSMMMSSSMMMSSSMSSPPP
PPPSSSSMMMSSSMMMSSSMMMSSSMMMSSSMMMSSSMMMSSSMMMSMMMSSSMMMSSSMMMSSSMMMSSSMMMSSSMMMSSSMMMSSSMMMSSSMSPPP
PPPSSSSSMMMSSSMMMSSSMMMSSSMMMSSSMMMSSSMMMSSSMMMSMMMSSSMMMSSSMMMSSSMMMSSSMMMSSSMMMSSSMMMSSSMMMSSSSPPP
PPPSSSSSSMMMSSSMMMSSSMMMSSSMMMSSSMMMSSSMMMSSSMMMSMMMSSSMMMSSSMMMSSSMMMSSSMMMSSSMMMSSSMMMSSSMMMSSSPPP
PPPSSSSSSSSSSSSSSSSSSSSSSSSSSSSSSSSSSSSSSSSGSSSSSSSSSSSSSSSSSSSSSSSSSSSSSSSSSSSSSSSSSSSSSSSSSSSSSPPP
PPPSSSSSSSSSSSSSSSSSSSSSSSSSSSSSSSSSSSSSSSSSSSSSSSSSSSSSSSSSSSSSSSSSSSSSSSSSSSSSSSSSSSSSSSSSSSSSSPPP
PPPSSSSSSSSSMMMSSSMMMSSSMMMSSSMMMSSSMMMSSSMMMSSSMMMSMMMSSSMMMSSSMMMSSSMMMSSSMMMSSSMMMSSSMMMSSSMSSPPP
PPPSSSSSSSSSSMMMSSSMMMSSSMMMSSSMMMSSSMMMSSSMMMSSSMMMSMMMSSSMMMSSSMMMSSSMMMSSSMMMSSSMMMSSSMMMSSSMSPPP
PPPSSSSSSSSSSSMMMSSSMMMSSSMMMSSSMMMSSSMMMSSSMMMSSSMMMSMMMSSSMMMSSSMMMSSSMMMSSSMMMSSSMMMSSSMMMSSSSPPP
PPPSSSMMMSSSMMMSSSMMMSSSMMMSSSMMMSSSMMMSSSMMMSMMMSSSMMMSSSMMMSSSMMMSSSMMMSSSMMMSSSMMMSSSMMMSSSMSSPPP
PPPSSSSMMMSSSMMMSSSMMMSSSMMMSSSMMMSSSMMMSSSMMMSMMMSSSMMMSSSMMMSSSMMMSSSMMMSSSMMMSSSMMMSSSMMMSSSMSPPP
PPPSSSSSMMMSSSMMMSSSMMMSSSMMMSSSMMMSSSMMMSSSMMMSMMMSSSMMMSSSMMMSSSMMMSSSMMMSSSMMMSSSMMMSSSMMMSSSSPPP
PPPSSSSSSMMMSSSMMMSSSMMMSSSMMMSSSMMMSSSMMMSSSMMMSMMMSSSMMMSSSMMMSSSMMMSSSMMMSSSMMMSSSMMMSSSMMMSSSPPP
PPPSSSSSSSSSSSSSSSSSSSSSSSSSSSSSSSSSSSSSSSSGSSSSSSSSSSSSSSSSSSSSSSSSSSSSSSSSSSSSSSSSSSSSSSSSSSSSSPPP
PPPSSSSSSSSSSSSSSSSSSSSSSSSSSSSSSSSSSSSSSSSSSSSSSSSSSSSSSSSSSSSSSSSSSSSSSSSSSSSSSSSSSSSSSSSSSSSSSPPP
PPPSSSSSSSSMMMSSSMMMSSSMMMSSSMMMSSSMMMSSSMMMSSSMMMSMMMSSSMMMSSSMMMSSSMMMSSSMMMSSSMMMSSSMMMSSSMMMSPPP
PPPSSSSSSSSSMMMSSSMMMSSSMMMSSSMMMSSSMMMSSSMMMSSSMMMSMMMSSSMMMSSSMMMSSSMMMSSSMMMSSSMMMSSSMMMSSSMSSPPP
PPPSSSSSSSSSSMMMSSSMMMSSSMMMSSSMMMSSSMMMSSSMMMSSSMMMSMMMSSSMMMSSSMMMSSSMMMSSSMMMSSSMMMSSSMMMSSSMSPPP
PPPSSSSSSSSSSSMMMSSSMMMSSSMMMSSSMMMSSSMMMSSSMMMSSSMMMSMMMSSSMMMSSSMMMSSSMMMSSSMMMSSSMMMSSSMMMSSSSPPP
PPPSSSMMMSSSMMMSSSMMMSSSMMMSSSMMMSSSMMMSSSMMMSMMMSSSMMMSSSMMMSSSMMMSSSMMMSSSMMMSSSMMMSSSMMMSSSMSSPPP
PPPSSSSSSSSSMMMSSSMMMSSSMMMSSSMMMSSSMMMSSSMMMSSSMMMSMMMSSSMMMSSSMMMSSSMMMSSSMMMSSSMMMSSSMMMSSSMSSPPP
PPPSSSSSSSSMMMSSSMMMSSSMMMSSSMMMSSSMMMSSSMMMSSSMMMSMMMSSSMMMSSSMMMSSSMMMSSSMMMSSSMMMSSSMMMSSSMMMSPPP
PPPSSSSSSSSSSSSSSSSSSSSSSSSSSSSSSSSSSSSSSSSGSSSSSSSSSSSSSSSSSSSSSSSSSSSSSSSSSSSSSSSSSSSSSSSSSSSSSPPP
PPPSSSSSSSSSSSSSSSSSSSSSSSSSSSSSSSSSSSSSSSSSSSSSSSSSSSSSSSSSSSSSSSSSSSSSSSSSSSSSSSSSSSSSSSSSSSSSSPPP
PPPSSSSSSSSSMMMSSSMMMSSSMMMSSSMMMSSSMMMSSSMMMSSSMMMSMMMSSSMMMSSSMMMSSSMMMSSSMMMSSSMMMSSSMMMSSSMSSPPP
PPPSSSSSSSSSSMMMSSSMMMSSSMMMSSSMMMSSSMMMSSSMMMSSSMMMSMMMSSSMMMSSSMMMSSSMMMSSSMMMSSSMMMSSSMMMSSSMSPPP
PPPSSSSSSSSSSSMMMSSSMMMSSSMMMSSSMMMSSSMMMSSSMMMSSSMMMSMMMSSSMMMSSSMMMSSSMMMSSSMMMSSSMMMSSSMMMSSSSPPP
PPPSSSMMMSSSMMMSSSMMMSSSMMMSSSMMMSSSMMMSSSMMMSMMMSSSMMMSSSMMMSSSMMMSSSMMMSSSMMMSSSMMMSSSMMMSSSMSSPPP
PPPSSSSMMMSSSMMMSSSMMMSSSMMMSSSMMMSSSMMMSSSMMMSMMMSSSMMMSSSMMMSSSMMMSSSMMMSSSMMMSSSMMMSSSMMMSSSMMPPP
PPPSSSSSMMMSSSMMMSSSMMMSSSMMMSSSMMMSSSMMMSSSMMMSMMMSSSMMMSSSMMMSSSMMMSSSMMMSSSMMMSSSMMMSSSMMMSSSSPPP
PPPSSSSSSMMMSSSMMMSSSMMMSSSMMMSSSMMMSSSMMMSSSMMMSMMMSSSMMMSSSMMMSSSMMMSSSMMMSSSMMMSSSMMMSSSMMMSSSPPP
PPPSSSSSSSMMMSSSMMMSSSMMMSSSMMMSSSMMMSSSMMMSSSMMMSMMMSSSMMMSSSMMMSSSMMMSSSMMMSSSMMMSSSMMMSSSMMMSSPPP
PPPSSSSSSSSMMMSSSMMMSSSMMMSSSMMMSSSMMMSSSMMMSSSMMMSMMMSSSMMMSSSMMMSSSMMMSSSMMMSSSMMMSSSMMMSSSMMMSPPP
PPPSSSSSSSSSSSSSSSSSSSSSSSSSSSSSSSSSSSSSSSSGSSSSSSSSSSSSSSSSSSSSSSSSSSSSSSSSSSSSSSSSSSSSSSSSSSSSSPPP
PPPSSSSSSSSSSSSSSSSSSSSSSSSSSSSSSSSSSSSSSSSSSSSSSSSSSSSSSSSSSSSSSSSSSSSSSSSSSSSSSSSSSSSSSSSSSSSSSPPP
PPPSSSSSSSSSSSMMMSSSMMMSSSMMMSSSMMMSSSMMMSSSMMMSSSMMMSMMMSSSMMMSSSMMMSSSMMMSSSMMMSSSMMMSSSMMMSSSSPPP
PPPSSSMMMSSSMMMSSSMMMSSSMMMSSSMMMSSSMMMSSSMMMSMMMSSSMMMSSSMMMSSSMMMSSSMMMSSSMMMSSSMMMSSSMMMSSSMSSPPP
PPPSSSSMMMSSSMMMSSSMMMSSSMMMSSSMMMSSSMMMSSSMMMSMMMSSSMMMSSSMMMSSSMMMSSSMMMSSSMMMSSSMMMSSSMMMSSSMSPPP
PPPSSSSSMMMSSSMMMSSSMMMSSSMMMSSSMMMSSSMMMSSSMMMSMMMSSSMMMSSSMMMSSSMMMSSSMMMSSSMMMSSSMMMSSSMMMSSSSPPP
PPPSSSSSSSSSSSSSSSSSSSSSSSSSSSSSSSSSSSSSSSSGSSSSSSSSSSSSSSSSSSSSSSSSSSSSSSSSSSSSSSSSSSSSSSSSSSSSSPPP
PPPSSSSSSSSMMMSSSMMMSSSMMMSSSMMMSSSMMMSSSMMMSSSMMMSMMMSSSMMMSSSMMMSSSMMMSSSMMMSSSMMMSSSMMMSSSMMMSPPP
PPPSSSSSSSSSMMMSSSMMMSSSMMMSSSMMMSSSMMMSSSMMMSSSMMMSMMMSSSMMMSSSMMMSSSMMMSSSMMMSSSMMMSSSMMMSSSMSSPPP
PPPSSSSSSSSSSMMMSSSMMMSSSMMMSSSMMMSSSMMMSSSMMMSSSMMMSMMMSSSMMMSSSMMMSSSMMMSSSMMMSSSMMMSSSMMMSSSMSPPP
PPPSSSSSSSSSSSMMMSSSMMMSSSMMMSSSMMMSSSMMMSSSMMMSSSMMMSMMMSSSMMMSSSMMMSSSMMMSSSMMMSSSMMMSSSMMMSSSSPPP
PPPSSSMMMSSSMMMSSSMMMSSSMMMSSSMMMSSSMMMSSSMMMSMMMSSSMMMSSSMMMSSSMMMSSSMMMSSSMMMSSSMMMSSSMMMSSSMSSPPP
PPPSSSSMMMSSSMMMSSSMMMSSSMMMSSSMMMSSSMMMSSSMMMSMMMSSSMMMSSSMMMSSSMMMSSSMMMSSSMMMSSSMMMSSSMMMSSSMSPPP
PPPSSSSSMMMSSSMMMSSSMMMSSSMMMSSSMMMSSSMMMSSSMMMSMMMSSSMMMSSSMMMSSSMMMSSSMMMSSSMMMSSSMMMSSSMMMSSSSPPP
PPPSSSSSSMMMSSSMMMSSSMMMSSSMMMSSSMMMSSSMMMSSSMMMSMMMSSSMMMSSSMMMSSSMMMSSSMMMSSSMMMSSSMMMSSSMMMSSSPPP
PPPSSSSSSSSSSSSSSSSSSSSSSSSSSSSSSSSSSSSSSSSGSSSSSSSSSSSSSSSSSSSSSSSSSSSSSSSSSSSSSSSSSSSSSSSSSSSSSPPP
PPPSSSSSSSSSSSSSSSSSSSSSSSSSSSSSSSSSSSSSSSSSSSSSSSSSSSSSSSSSSSSSSSSSSSSSSSSSSSSSSSSSSSSSSSSSSSSSSPPP
PPPSSSSSSSSSMMMSSSMMMSSSMMMSSSMMMSSSMMMSSSMMMSSSMMMSMMMSSSMMMSSSMMMSSSMMMSSSMMMSSSMMMSSSMMMSSSMSSPPP
PPPSSSSSSSMMMSSSMMMSSSMMMSSSMMMSSSMMMSSSMMMSSSMMMSMMMSSSMMMSSSMMMSSSMMMSSSMMMSSSMMMSSSMMMSSSMMMSSPPP
PPPSSSMMMSSSMMMSSSMMMSSSMMMSSSMMMSSSMMMSSSMMMSMMMSSSMMMSSSMMMSSSMMMSSSMMMSSSMMMSSSMMMSSSMMMSSSMSSPPP
PPPSSSSMMMSSSMMMSSSMMMSSSMMMSSSMMMSSSMMMSSSMMMSMMMSSSMMMSSSMMMSSSMMMSSSMMMSSSMMMSSSMMMSSSMMMSSSMSPPP
PPPSSSSMMMSSSMMMSSSMMMSSSMMMSSSMMMSSSMMMSSSMMMSMMMSSSMMMSSSMMMSSSMMMSSSMMMSSSMMMSSSMMMSSSMMMSSSMSPPP
PPPSSSMMMSSSMMMSSSMMMSSSMMMSSSMMMSSSMMMSSSMMMSMMMSSSMMMSSSMMMSSSMMMSSSMMMSSSMMMSSSMMMSSSMMMSSSMSSPPP
PPPSSSSSSSMMMSSSMMMSSSMMMSSSMMMSSSMMMSSSMMMSSSMMMSMMMSSSMMMSSSMMMSSSMMMSSSMMMSSSMMMSSSMMMSSSMMMSSPPP
PPPSSSSSSSSSSSSSSSSSSSSSSSSSSSSSSSSSSSSSSSSGSSSSSSSSSSSSSSSSSSSSSSSSSSSSSSSSSSSSSSSSSSSSSSSSSSSSSPPP
PPPPPPPPPPPPPPPPPPPPPPPPPPPPPPPPPPPPPPPPPPPPPPPPPPPPPPPPPPPPPPPPPPPPPPPPPPPPPPPPPPPPPPPPPPPPPPPPPPPP
PPPPPPPPPPPPPPPPPPPPPPPPPPPPPPPPPPPPPPPPPPPPPPPPPPPPPPPPPPPPPPPPPPPPPPPPPPPPPPPPPPPPPPPPPPPPPPPPPPPP
PPPPPPPPPPPPPPPPPPPPPPPPPPPPPPPPPPPPPPPPPPPPPPPPPPPPPPPPPPPPPPPPPPPPPPPPPPPPPPPPPPPPPPPPPPPPPPPPPPPP
